8 12
1 0
7 7
************
   ***     *  
**   * *** *   
*  *   *   * 
* * ****** * 
* *    **  *  
*   *     ** 
******* ****